{
  "success": true,
  "stud":  ["130071601091",
            "130071601092",
            "130071601093",
            "130071601094",
            "130071601095",
            "130071601096",
            "130071601097",
            "130071601098",
            "130071601099"
           ]
}
